17 6
TTTTTTTTTTTTTTTTT
T...+R.*........T
T....RLR.~......T
T...TTx.....~...T
T...+R......+...T
TTTTTTTTTTTTTTTTT